#################~~~~~~~~~~
#################    =~   #
     ~~~~    ==   =~==~   #
     ~~S~~  ====  ==~=~~  #
     ===~~   #==   =~=~~  #
     ===~~  ###    =~     #
     ===~~  ##   ###~     #
 =~              ## ~   ###
 =~      ##  == =~ =    ###
      ==###  == =~      ###
##########   ==         ###
~~~~~~~~         ~~~~##~   
 ### # # ### ### ====##=   
 # # # # #   # #   ==~~~=  
 ### # # #   ###   =~~~==  
 #   # # #   #     =##~    
 #   ### ### #     =##     
~~~~~~~~~~~~~~~~~~~~~~~~~~E