###########################
###~~~~~~~~~~~~~~~~  ~~   #
#I         #   #####      #
#   #####  #           G  #
#    ~~~~~~#~  #######    #
#   #~~~~~~~~        #    #
# ~ #~~~~######      #    #
# ~ #                #~~~ #
# ~ #                #~~~ #
# ~                  #~ ~ #
# ~### # # ### ###        #
# ~# # # # #   # #        #
# ~### # # #   ###        #
# ~#   # # #   #    #~~ ~ #
# ~#   ### ### #    #~~~~ #
#                   #~~~~ #
##   ###            #~~~~ #
#    ###            ~~~~~ #
#  S  ######~~~~~~  ~~~~~ #
#     #     ~~~~~~  ~~~~~ #
#~    #             ~~~~~ #
#~     ~~~~~~         ### #
# ~    ~~~~~~     #       #
#   ########~     #       #
#      ~~~~~~~~~~ #       #
#               ~ #       #
###########################